{
  "003": {
    "成王": "周成王"
  },
  "004": {
    "元王": "周元王",
    "共王": "周共王",
    "匡王": "周匡王",
    "厉公": "郑厉公",
    "厉王": "周厉王",
    "哀王": "周哀王",
    "安王": "周安王",
    "定王": "周定王",
    "宣王": "周宣王",
    "平王": "周平王",
    "幽王": "周幽王",
    "庄王": "周庄王",
    "康公": "密康公",
    "康王": "周康王",
    "思王": "周思王",
    "悼王": "周悼王",
    "惠公": "东周惠公",
    "惠王": "周惠王",
    "懿王": "周懿王",
    "成王": "周成王",
    "敬王": "周敬王",
    "文王": "周文王",
    "昭王": "周昭王",
    "显王": "周显王",
    "景王": "周景王",
    "桓王": "周桓王",
    "武王": "周武王",
    "灵王": "周灵王",
    "烈王": "周烈王",
    "献公": "秦献公",
    "穆王": "周穆王",
    "简王": "周简王",
    "考王": "周考王",
    "襄王": "周襄王",
    "釐王": "周釐王"
  },
  "005": {
    "共公": "秦共公",
    "哀公": "齐哀公",
    "孝公": "秦孝公",
    "宣公": "齐宣公",
    "幽王": "周幽王",
    "庄公": "秦庄公",
    "怀公": "秦怀公",
    "悼公": "秦悼公",
    "惠公": "秦惠公",
    "文公": "秦文公",
    "桓公": "秦桓公",
    "武王": "秦武王",
    "灵公": "秦灵公",
    "献公": "秦献公",
    "简公": "秦简公",
    "缪公": "秦缪公",
    "襄公": "秦襄公"
  },
  "006": {
    "共公": "秦共公",
    "出公": "秦出公",
    "孝公": "秦孝公",
    "康公": "秦康公",
    "怀公": "秦怀公",
    "悼公": "秦悼公",
    "惠公": "秦惠公",
    "文公": "秦文公",
    "景公": "秦景公",
    "桓公": "秦桓公",
    "武公": "秦武公",
    "灵公": "秦灵公",
    "献公": "秦献公",
    "简公": "秦简公",
    "缪公": "秦缪公",
    "襄公": "秦襄公"
  },
  "007": {
    "怀王": "楚怀王"
  },
  "008": {
    "怀王": "楚怀王"
  },
  "013": {
    "厉公": "秦厉公",
    "成王": "周成王",
    "文王": "文王昌"
  },
  "016": {
    "怀王": "楚怀王"
  },
  "017": {
    "惠王": "悼惠王"
  },
  "018": {
    "文侯": "韩文侯",
    "昭王": "赵昭王",
    "顷侯": "燕顷侯"
  },
  "019": {
    "哀侯": "韩哀侯",
    "哀王": "齐哀王"
  },
  "028": {
    "成王": "周成王",
    "文公": "秦文公",
    "文王": "周文王",
    "桓公": "齐桓公",
    "缪公": "秦缪公"
  },
  "031": {
    "武公": "卫武公",
    "武王": "周武王"
  },
  "032": {
    "厉公": "齐厉公",
    "哀公": "齐哀公",
    "孝公": "齐孝公",
    "宣公": "齐宣公",
    "平公": "齐平公",
    "庄公": "齐庄公",
    "康公": "齐康公",
    "悼公": "齐悼公",
    "懿公": "齐懿公",
    "成公": "成公脱",
    "文公": "齐文公",
    "文王": "周文王",
    "景公": "齐景公",
    "武公": "武公寿",
    "灵公": "齐灵公",
    "献公": "齐献公",
    "简公": "齐简公",
    "顷公": "齐顷公"
  },
  "033": {
    "成王": "周成王",
    "文王": "周文王",
    "武王": "周武王"
  },
  "034": {
    "平公": "燕平公",
    "悼公": "晋悼公",
    "成王": "周成王",
    "桓侯": "齐桓侯",
    "献公": "燕献公",
    "简公": "燕简公",
    "襄公": "晋襄公",
    "釐侯": "燕釐侯",
    "顷侯": "燕顷侯"
  },
  "035": {
    "哀侯": "蔡哀侯",
    "庄公": "庄公夕姑",
    "文侯": "文侯申",
    "文王": "周文王",
    "昭侯": "蔡昭侯",
    "釐公": "釐公夷"
  },
  "038": {
    "共公": "宋共公",
    "平公": "宋平公",
    "平王": "楚平王",
    "庄公": "宋庄公",
    "庄王": "楚庄王",
    "惠公": "宋惠公",
    "昭公": "卫昭公",
    "景公": "宋景公",
    "武公": "鲁武公",
    "武王": "周武王",
    "灵王": "楚灵王",
    "穆公": "宋穆公"
  },
  "039": {
    "共公": "宋共公",
    "共王": "楚共王",
    "出公": "晋出公",
    "匡王": "周匡王",
    "厉公": "晋厉公",
    "厉王": "周厉王",
    "哀侯": "晋哀侯",
    "哀公": "晋哀公",
    "孝公": "齐孝公",
    "定公": "晋定公",
    "幽公": "晋幽公",
    "幽王": "周幽王",
    "庄公": "晋庄公",
    "悼公": "晋悼公",
    "惠公": "晋惠公",
    "惠王": "周惠王",
    "敬王": "周敬王",
    "文侯": "晋文侯",
    "文公": "晋文公",
    "昭公": "晋昭公",
    "桓公": "齐桓公",
    "武公": "晋武公",
    "武王": "周武王",
    "灵公": "赵灵公",
    "烈公": "晋烈公",
    "献公": "晋献公",
    "穆侯": "晋穆侯",
    "缪公": "秦缪公",
    "襄王": "周襄王",
    "釐王": "周釐王",
    "顷公": "齐顷公"
  },
  "044": {
    "孝公": "秦孝公",
    "惠王": "魏惠王",
    "襄王": "魏襄王"
  },
  "049": {
    "成王": "周成王"
  },
  "050": {
    "襄王": "楚顷襄王"
  },
  "060": {
    "成王": "周成王",
    "武王": "周武王"
  },
  "067": {
    "哀公": "鲁哀公",
    "庄公": "鲁庄公",
    "昭公": "鲁昭公"
  },
  "071": {
    "昭王": "秦昭王",
    "武王": "秦武王"
  },
  "078": {
    "文王": "楚文王"
  },
  "079": {
    "昭王": "秦昭王"
  },
  "087": {
    "惠王": "秦惠王",
    "简公": "秦简公"
  },
  "088": {
    "成王": "周成王"
  },
  "099": {
    "成王": "周成王",
    "武王": "周武王"
  },
  "110": {
    "悼公": "魏悼公",
    "武王": "周武王"
  },
  "118": {
    "厉王": "淮南厉王"
  },
  "128": {
    "元王": "宋元王",
    "文王": "周文王",
    "武王": "周武王"
  },
  "130": {
    "武王": "周武王"
  }
}